Anneke|Anneke Løkken
Nariat|Nariat Pasheva
Nicolle|Nicolle Rose Garnes
Eileén|Eileén Storækre Harsvik
Elén|Elén Linchausen Skar
Temitope|Temitope Adeola Olalemi
Befrin|Befrin Mikail
Vetle-Martines|Vetle-Martines Thorsheim Turøy
Gunleik|Gunleik Sandland
Darshih|Darshih Okbit Meleake
Antero|Antero Rinne
Myriam|Myriam Wang
Beathe|Beathe Nordås
Cleo|Cleo Nyborg
Amani|Amani Khan
Ol-Duommá|Ol-Duommá Utsi
Mariatu|Mariatu Jalloh
Venche|Venche Renate Brattli
Harrieth|Harrieth Toft Nordrum
Shukri|Shukri Ali Isse
Naado|Naado Muktar
Elice|Elice Bergmo Store
Tolene|Tolene Lovise F Karlsen
Niamh|Niamh Brekkhus
Massi|Massi Hassip
Chrisander|Chrisander Finsrud Dalen
Mesfin|Mesfin Legese
Mebrahtu|Mebrahtu Werede
Hedda-Marie|Hedda-Marie Nesheim
Clarisse|Clarisse Favé
Arntraut|Arntraut Götsch
Hill|Hill Irene Remlo
Kari-Esther|Kari-Esther Selvaag Høgevold
Lineah|Lineah Elise Etnan
Manmeet|Manmeet Kaur Bandesha
Jaimee|Jaimee Connie San Pedro
Tifani|Tifani Litvinaite
Kári|Kári Gylfason
Peik|Peik Ask
Abigial|Abigial Abebe Techane
Ricce|Ricce Furnes
Neele|Neele Tincman-Aune
Hareeni|Hareeni Subanendrajah
Dione|Dione Scarlet Kolle Ekaney
Brigid|Brigid Mary Kormany
Serine-Ariel|Serine-Ariel Thorsheim Turøy
Mina-Marie|Mina-Marie Sørdahl Finsveen
Lamek|Lamek Tesfai
Sayom|Sayom Bhuiyan
Aile|Aile Heatta Kuhmunen
Maid|Maid Nahhas
Gudni|Gudni Leo Peersen Mariusson
Armann|Armann Saastad Haugan
Javad|Javad Norouzi
Sejjad|Sejjad Noor Ali
Seb|Seb Anthony
Marlieke|Marlieke Husslage
May-Brit|May-Brit Rostad
Nicky|Nicky Thomas Draganchuk
Irrfe|Irrfe Renz Bagol
Tommie|Tommie Antonsen
Ugne|Ugne Norvaisaite
Philipp|Philipp Einar Grubmueller
Britt-Karin|Britt-Karin Sandbakken
Shuruthy|Shuruthy Tharmavanan
Rait|Rait Veesalu
Junifer|Junifer Isadora Cordelia Baggethun
Tesfay|Tesfay Brhane
Raoul|Raoul Ranveer Singh
Mouhamed|Mouhamed Abounnachat
Tehani|Tehani Ganeshalingam
Thach|Thach Kien Ho
Tille|Tille Margrethe Haukeli
Aimal|Aimal Khan
Thorkild|Thorkild Schrumpf
Ghebremedhn|Ghebremedhn Teklebrhan Hagos
Lisbet|Lisbet Løvstad
Ingalill|Ingalill Stang
Grame|Grame Monsanda
Unn-Christin|Unn-Christin Lande
Mac|Mac Gustav Torsten Wredmark
Athmad|Athmad Nabeeh
Fridthjof|Fridthjof Snorrason
Malin-Isabel|Malin-Isabel Solvang Eliassen
Frøyd|Frøyd Ludviksen
Sunlight|Sunlight Tewelde
Helén|Helén Strand
Aini|Aini Postila
Arlie|Arlie Isabella Petersen
Kolbeinn|Kolbeinn Boi Bjarkason
Mattéo|Mattéo Dupont
Aboltazi|Aboltazi Mousavi
Minni|Minni Elise Brandvik Aakvik
Vidkun|Vidkun Haugli
Pau|Pau Sundal Gese Jarque
Lilou|Lilou Bendiksen
Kheiro|Kheiro Oine
Tollef|Tollef Otterdal Heggen
Gabril|Gabril Waagaard
Fartun|Fartun Ibrahim
Dafne|Dafne Seeber
Ange|Ange Shanel Koffi
Danil|Danil Przhehorlynskiy
Radin|Radin Kalbasi
Kittil|Kittil Olav Haugen
Gift|Gift Goronsa
Houssam|Houssam Maamoun Khallouf
Aland|Aland Muhammed
Dagfin|Dagfin Reium
Olexander|Olexander Zhekov
Ezekiel|Ezekiel Yoshua
Noemi|Noemi Ambauen
Lukasz|Lukasz Charkiewicz
Fthi|Fthi Debesay Abraham
Edoardo|Edoardo Barbens
Izatullah|Izatullah Miakhail
Maikee|Maikee Delos Santos
Nicolaj|Nicolaj Tidemand
Miliane|Miliane Ekstrand
Borys|Borys Pieczkowski
Deil|Deil Yuwan Alba Askeland
Aleksandro|Aleksandro Diaz
Kibrom|Kibrom Tewelde
Rikardo|Rikardo Mikalsen Gojkovic
Martim|Martim De Freitas Lopes
Tang|Tang Gech
Nouri|Nouri Abdulla
Vicente|Vicente Modahl
Hein|Hein Rune Skjoldal
Isatu|Isatu Kamara
Marlinn|Marlinn Inntveit
Tyri|Tyri Røset Finnes
Namreet|Namreet Kaur
Veide|Veide Ertsås
Sije|Sije Tangen Gundersen
Karlene|Karlene Selliken
Sofi|Sofi Ahmad
Sonje|Sonje Brøndmo
Gaël|Gaël Gelis
Erdi|Erdi Hiabu
Shadreck|Shadreck Chidiadia
Lycie|Lycie Mobmo Rwitabira
Fanni|Fanni Jauhojärvi Markussen
Fernande|Fernande Kjenner
Hvamstad|Hvamstad Hanna Skjaker
Staxrud|Staxrud Siri Brænden
Sveinulv|Sveinulv Ueland
Tangnes|Tangnes Tonje
Boss|Boss Vedal
Madjd|Madjd Nahas
Shalam|Shalam Beyene
Hafso|Hafso Elmi
Synnev|Synnev Trømborg Hoviosen
Eddie|Eddie Mikal Ebbesvik
L|L H Stangeland
Sif|Sif L.C. Bølstad
Cecile|Cecile Brekke Rygh
Valentino|Valentino Bye Vevle
Noomi|Noomi Kjetland
Umutoniwase|Umutoniwase Kevine Habimana
Abier|Abier Mohammad
Ariane|Ariane Lillemo
Shewit|Shewit Tesfaye
Adonai|Adonai Kidane
Jul|Jul Fr. Kaltenborn
Eindride|Eindride Hungnes
Adler|Adler Haugland
Churt|Churt Loose
Aham|Aham Okeke
Bjørne|Bjørne Berre
Svei|Svei Vidar Kråkøy
Rønning|Rønning Tollefsen
Beimnet|Beimnet Haile Wolday
Ånund|Ånund Hansen Kjestveit
Kariann|Kariann Refvem
Raimond|Raimond Blakstad
Tesfaye|Tesfaye Bekele
Juul|Juul Fredrik Kaltenborn
Eigill|Eigill Fareth
Blu|Blu William Opland
Emme|Emme Rebecka Ofstad
Luise|Luise Wietschorke
Firaol|Firaol Weuweyyeson
Lune|Lune Harriette van Hulst
Catherin|Catherin Kongmanee
Authapl|Authapl Chonpun
Mikel|Mikel Girma
Mahvash|Mahvash Akhtari
Azmy|Azmy Færøy
Fidel|Fidel Agbor Moi
Gavril|Gavril Morenko
Karle|Karle Pulli Balsnes
Liah|Liah Velten Klubbeng
Helin|Helin Zaman
Yannick|Yannick Lysander Hall
Nazim|Nazim Rizai
Esrin|Esrin Durak
Minassie|Minassie Berhane
Mikhael|Mikhael Velve
Heiki|Heiki Haugland
Ovidie|Ovidie Barstad Nerbø
Artin|Artin Aga
Muqkurtaj|Muqkurtaj Durim
Emrah|Emrah Bol
Johsander|Johsander Nordvik
Tsegazeab|Tsegazeab Kasahun Bahta
Adi|Adi Trbonja
Bjørn-Tore|Bjørn-Tore Sundet
Thorvild|Thorvild Thomassen
Ingval|Ingval Falch
Askill|Askill Voll
Elud|Elud Isak
Kleng|Kleng Brekkå
Notto|Notto T. Moseid
Shahd|Shahd Mahmoud Mohammad
Danyil|Danyil Dromenko
Ingolv|Ingolv Krogstad
Reidulv|Reidulv Førde
Bertel|Bertel Bjørvik
Geder|Geder Gartland
Sahid|Sahid Aden
Heming|Heming Kolstad
Thommy|Thommy Evensen
Tri|Tri M. Dang
Chisom|Chisom Okeke
Jave|Jave Beloy
Bergfinn|Bergfinn Storlimo
Berndt|Berndt Johansson
Zahidullah|Zahidullah Baghlanai
Batoul|Batoul Alnashef
Minnetallah|Minnetallah Abazid
Najmo|Najmo Mohamed Abukar
Hersiddhe|Hersiddhe Tak
Lief|Lief Haug
Toivo|Toivo Skogheim
Torberg|Torberg Falch
Trygg|Trygg Syversen
Janani|Janani Kandiah
Jeger|Jeger Koksvik
Gunleiv|Gunleiv Kåsa
Riziki|Riziki Allen
Karoly|Karoly Greff
Kayyo|Kayyo Kissi Buli
Beng|Beng Mundheim
Dimitri|Dimitri Halseide
Teklu|Teklu Gebregziabher
Hellik|Hellik N. Livland
Umulkheer|Umulkheer Ibrahim Abdi
Inger-Liv|Inger-Liv Bjertnes
Annicke|Annicke Stranda
Audny|Audny Breivik
Liv-Reidun|Liv-Reidun Næss
Amal|Amal Nakouh
Totto|Totto Myrvang
Inger-Cecilie|Inger-Cecilie Østensen
Linn-Anneth|Linn-Anneth Myrann
Liv-Miriam|Liv-Miriam Nordtømme
Haile|Haile Tesfai Brhane
Nogaye|Nogaye Moe
Åse-Marie|Åse-Marie Muggerud
Gertrud|Gertrud Færavaag
Berly|Berly Hovland
May-Unni|May-Unni Berglund
Sylvi|Sylvi Vullum
Edit|Edit Iren Vollsund
Rone|Rone Hostvedt Aarthun
Åro|Åro Eide
Yngvill|Yngvill Myhre
Minny|Minny Olavsen Malerud
Chaltu|Chaltu Chaltu
Thove|Thove Marie Johansen
Mari-Louise|Mari-Louise Papsdorff
Ranid|Ranid Vermelid
Rosalind|Rosalind Weydahl
Gørild|Gørild Nøkland
Kari-Ann|Kari-Ann Myhre
Bergit|Bergit Andersson
Liss|Liss Bakke
Brigitte|Brigitte Kristoffersen
Raif|Raif Holden
Else-Marie|Else-Marie Laksnes
Cæcilie|Cæcilie Riis
Britt-Elin|Britt-Elin Hjøllo
Siri-Merete|Siri-Merete Alfheim
Solyane|Solyane Berhe
Chahed|Chahed Zahreddine
Xin|Xin Adian Benum Luong
Oliane|Oliane Liholt Nilssen
Májjá|Májjá Johanna P. Smuk
Ellah|Ellah Noemi Rønning
Samsom|Samsom Musiande
Abod|Abod Tamem
Scrasak|Scrasak Songwongyat
André-Timéo|André-Timéo Kamanou
Wouter|Wouter Mols
Odd-Olav|Odd-Olav Aga
Bergliot|Bergliot Aarbø Olsen
Ekolai|Ekolai L. Bang Lunde
Gaile|Gaile Baskys
Christel|Christel Einan
Filippo|Filippo Sanfilippo
Sjalg|Sjalg Løvseth Øvstehage
Odd-Anders|Odd-Anders Grimsbø
Yahnick|Yahnick Adams
Tollak|Tollak Lunde
Suresh|Suresh Murugesu
Bjørn-Jarle|Bjørn-Jarle Willassen
Hedwig|Hedwig Mehland
Leszek|Leszek Jan Pokrywka
Frank-Tore|Frank-Tore Dølerud
Zahr|Zahr Shamiyah
Wilatrat|Wilatrat Yaemsa-Art
Dachawut|Dachawut Srihan
Rebeca-Miriam|Rebeca-Miriam Preda
Gray|Gray Abel
Momoh|Momoh Sesay
Anyelo|Anyelo Rosario
Berner|Berner Skeie
Mahamedd|Mahamedd Jamal Ibrahim
Mati|Mati Koiv
Hazrat|Hazrat Ali Hurakel
Emiliano|Emiliano Vuillermoz
Eliezer|Eliezer de Oleo Taveras
Fahad|Fahad Alrantisi
Thile|Thile Andreas Erlandsen
Martijn|Martijn Langeweg
Halgrim|Halgrim Vebjørn Gaupeland
Batul|Batul Mohammed
Tang|Tang Geck
Latif|Latif Hoseini
Athish|Athish Ganeshalingam
Mickel|Mickel Segalstad-Slaatto
Marcelo|Marcelo Hetland Strand
Olivér|Olivér Wiik-Stoltz
Massimiliano|Massimiliano Dijkgraaf
Anselm|Anselm Reichenbach
Mourad|Mourad Touil
Shanett|Shanett Olsen Dahlskjær
Sigge|Sigge Smedmark
Ahlam|Ahlam Moalim
Binhasi|Binhasi Abdigasy Mohamud
Eugene|Eugene Robert Løvmo Rønning
Iraq|Iraq Izdihar Al-Iedani
Remo|Remo Mathias Koht Johannessen
Cristiano|Cristiano Maysan Werede
Brieuc|Brieuc Mickael Watremetz
Tevje|Tevje Aunan
Hisham|Hisham Mohamed Abdi
Fawaz|Fawaz Khaled Zakaria
Alannah|Alannah C Patel
Maybel|Maybel Boateng
Nenneh|Nenneh Janko
Zaki|Zaki Haidary
Bahati|Bahati Kahindo
Shideh|Shideh Sadeghi
Annemari|Annemari Heggdal
Mariet|Mariet Anna Nijmeijer
Roisin|Roisin Ibs
Emmelin|Emmelin Bjørnvik
Berend|Berend Jan Nijmeijer
Ranvi|Ranvi Overrein
Angelin|Angelin Therese Thomas
Florient|Florient Ryunosuke Marcouiller
Velde|Velde Pedersen
Anthoni|Anthoni Monkornburi
Shurabi|Shurabi Suntharalingam
Emil-Andre|Emil-Andre Dahl
Karol|Karol Krzysztof Gorny
José|José Carlos Pinto
Svenn-Arne|Svenn-Arne Bjørkelo
Wim|Wim van den Broeck
Yobe|Yobe Najar
Imani|Imani Diane Modahl
Stian-Mikael|Stian-Mikael Madsen
Emanuels|Emanuels Egils Zaurins
Thivyesh|Thivyesh Ahilathasan
Tando|Tando Sigcau
Senay|Senay Amlesom Fissehatsion
Massod|Massod Parwany
Jaad|Jaad Orten
Seppe|Seppe Claessen
Mireille-Mëlanie|Mireille-Mëlanie Kamanda
Hillary|Hillary Kipchumba
Vadim|Vadim Pecherskii
Mahamed|Mahamed Abukar Siidi
Sannah|Sannah Stainsby
Sayed|Sayed Hussini
Gishe|Gishe Abdi Wako
Abu|Abu Mandefro Asefa
Leonid|Leonid Raiets
Halfdan-Emil|Halfdan-Emil Færø
Jerreh|Jerreh Ceesay
Luwam|Luwam Ghezai
Malky|Malky Frank
Jess|Jess Granlund
Hugne|Hugne Eik Sjo
Mhretu|Mhretu Dessalegn
Otilie|Otilie Børresen Bollingmo
Ume|Ume Salma Ahmed
Dag-Kjetil|Dag-Kjetil Hartberg
Abebe|Abebe Hunde
Afework|Afework Amelo Genale
Inger-Helene|Inger-Helene Martinsen
Alem|Alem Adhanom
Urige|Urige Arado Buta
Reinier|Reinier van der Spek
Lamiae|Lamiae Hassani
Willie|Willie Minit
Matthieu|Matthieu Bourg
Teemu|Teemu Juhani Pasanen
Oluf|Oluf Røsland
Dawt|Dawt Bik Sang Zathang
Jørn-Atle|Jørn-Atle Erichsen
Tengel|Tengel Glemming Thorsen
Ioustiniano|Ioustiniano Phocaeon
Amaru|Amaru Raighendler Jeasar Wijman
Jilke|Jilke Scheffer
Raji|Raji Negash Gebe
Ener|Ener Søberg Vaglum
Reiel|Reiel Daling Felde
Abulfazi|Abulfazi Masumi
Vitalo|Vitalo Vuga
Riquelvys|Riquelvys Rafael Santiago
Safiollah|Safiollah Shakibani
Tesfayohannes|Tesfayohannes M. Fisehti
Weldu|Weldu Negash Gebretsadik
Dadafo|Dadafo Tesama Dhaqabi
Ingvardt|Ingvardt Sandsund
Miroslaw|Miroslaw Baran
Alemayehu|Alemayehu Sitotaw
Geir-Arve|Geir-Arve M Clausen
Lavrants|Lavrants Kongssund
Ånung|Ånung Viken
Tomasz|Tomasz Siemieniuch
Korneliuz|Korneliuz Papina
Kanisorn|Kanisorn Yasri
Athiwat|Athiwat Nilsen
Izpiak|Izpiak Zahid
Théo|Théo Sevestre
Sytze|Sytze Rijpkema
Nii|Nii Mensah Narh
Milad|Milad Habibi
Maxim|Maxim Tjøtta
Deni|Deni Khazjmenzojev
Adisak|Adisak Sween
Nouraldin|Nouraldin Nia
Jijo|Jijo Gamachis
Nuno|Nuno Luis
Master|Master Anan Jongjai
Bienmet|Bienmet Kfle
Kimme|Kimme Arnesen
Ebrahim|Ebrahim Abdulaziz
Aloizs|Aloizs Cacs
Nagmeldin|Nagmeldin Ali Abubakar
Sadik|Sadik Mohammed
Zerei|Zerei Kbrom Mezngi
Dan-Olav|Dan-Olav Tjessem Meling
Freddie|Freddie Schumann
Valery|Valery Kakhnovich
Klemet|Klemet Issat Mienna
Nazif|Nazif Karimi
Knud|Knud Leerbeck
Najib|Najib Kakar
Izzatulah|Izzatulah Sultani
Warhel|Warhel Suleman
Williams|Williams Kollie
Fassu|Fassu Conde
Yann|Yann Kieffer
Shahez|Shahez Shwana
Gianni|Gianni Risbakk
Mihai|Mihai Anastasiu
Okubamichael|Okubamichael Mesfun Fissehatsion
Girmay|Girmay Kflemaryam
Dost|Dost Mohammed Sultani
Yaudi|Yaudi Fernandez
Merhawi|Merhawi Tadesse
Dusko|Dusko Drakic
Wiggo|Wiggo Bowitz
Arne-Frithjof|Arne-Frithjof Løken
Jozef|Jozef Zygmuntowicz
Bjørge|Bjørge Ruud
Bjøro|Bjøro Nevland
Loyd|Loyd Remi Solberg
Mikko|Mikko Beckstrøm Lindroos
Joyel|Joyel Reggie Amaladas
Sanjay|Sanjay Satkunananthan
Efe|Efe Topdemir
Thom|Thom Robert Kroken Næsse
Rony|Rony Adam
Gerry|Gerry Bains
Arin|Arin Veland
Jawid|Jawid Ahmadi
Laurent|Laurent Bathgate
Khualpi|Khualpi Hatzaw
Gylfi|Gylfi Ingvar Gylfason
Sergey|Sergey Adyasov
Rasmuss|Rasmuss Wernø Waage
Niladri|Niladri Banerjee
Gullbrand|Gullbrand Julius Aas
Sonny|Sonny Bolin
Uwe|Uwe Kant
Vyacheslav|Vyacheslav Mukhidinov
Hawsoz|Hawsoz Mustafa
Ben-Roger|Ben-Roger Dreyer
Zamzam|Zamzam Liyaas Mahamud
Stål|Stål Opdahl
Kentaro|Kentaro Indo
Hallgrim|Hallgrim Nakken
Jasin|Jasin Hussein Eidem
Karamjit|Karamjit Nahal
Suvaroj|Suvaroj Mingsakool
Sindri|Sindri Freyr Seim Sigurdsson
Gudleik|Gudleik Husby
Nobiel|Nobiel Zekarias Mehari
Hilal|Hilal Kataya
Filiph|Filiph Tilge
Richmond|Richmond Bendu
Toby|Toby Wesselingh
Fidele|Fidele Kinunda
Andi|Andi Hadri
Torkiel|Torkiel Westby
Brynjel|Brynjel Furnes Berland
Senam|Senam Julian Yao Asmussen
Dilip|Dilip Gengatharan
Ayo|Ayo Ranuh
Apisit|Apisit Saisin
Pandoyo|Pandoyo Ranuh
Sulumbek|Sulumbek Arsamakov
Mouhamad|Mouhamad Alsalem
Maikele|Maikele Tsegay
Ezatullah|Ezatullah Servary
Kalab|Kalab Birhane
Sergejs|Sergejs Kononovs
Mussie|Mussie Oukbe
Thamchot|Thamchot Kijlikit
Teame|Teame Tewelde
Gylve|Gylve Setlo
Jo-Inge|Jo-Inge Sandvik
Parhat|Parhat Arken
Jörg|Jörg Törpel
Nickolass|Nickolass Jensen
Mengs|Mengs Kesete
Anass|Anass Safiani
Lukacs|Lukacs Kalentics
Ingebrikt|Ingebrikt Johansen Hovik
Corne|Corne Donkelaar
Sigvart|Sigvart Johan Avdal
Gonzalo|Gonzalo Cabello
Naeem|Naeem Khan
Osazee|Osazee Parkson
Malte|Malte Sallan
Altaieb|Altaieb Hassan Haron
Rami|Rami Teklemariam
Miller|Miller Alexander Nesse
Evo|Evo Rosvoll Solskjær
Navid|Navid Zafari
Eiler|Eiler Kongsrud
Thevaky|Thevaky Murugasimman
Zohrez|Zohrez Khan
Janaann|Janaann Jay Johanraj
Nikhil|Nikhil Siegrist Silfverhielm
Cin|Cin Sian Lian Hatzaw
Oatthawut|Oatthawut Panklang
Linujann|Linujann Balasegar
Modou|Modou Lamin Conteh
Frikk|Frikk Alvaro Embergsrud
Sohrab|Sohrab Lingen Shirzadi
Pawel|Pawel Kucaj
Parwiz|Parwiz Akhtari
Arngrim|Arngrim Sørumshaugen
Sanjeth|Sanjeth Suthahar
Tore-Michael|Tore-Michael Engen
Merih|Merih Solomon Hailemicheal
Delani|Delani Reshane
Abhishek|Abhishek Jagga
Yoom|Yoom Eebbissa Nagaraa
Knut-Ole|Knut-Ole Rogneflåten
Lewi|Lewi Udelhoven
Nerushanth|Nerushanth Varathan
Simeone|Simeone Dorne
Thime|Thime Sæterstøl
Zeljko|Zeljko Milosavljvic
Järvi|Järvi Kjetil Stielstra
Tasaratsing|Tasaratsing Ratnasingam Gunenthiran
Langrød|Langrød Takis
Tino|Tino Lavergne-Nielsen
Oleander|Oleander Austmo
Rares|Rares Oprea
Vinni|Vinni Sebastian da Rosa Lie
Mink|Mink Fieten
Yohannes|Yohannes Kasahun Bahta
Mård|Mård Johannes Agjeld
Dallin|Dallin Mead
Robbie|Robbie Alver
Danial|Danial Ahmad Rana
Roberts|Roberts Naumenko
Gerenkial|Gerenkial Kibrom Abrha
Yassin|Yassin Osman Mohamud
Fraol|Fraol Kløvstad
Mahmood|Mahmood Mosevi
Mehretab|Mehretab Tsegay
Torvild|Torvild Dyrdal
Hazratdin|Hazratdin Utmanzai
Jovany|Jovany Nzita
Arne-Hugo|Arne-Hugo Hansen
Olger|Olger Breivik Pedersen
Muhanad|Muhanad Aswad
Børje|Børje Laastad
Leevi|Leevi Joonatan Puustinen
Knut-Olai|Knut-Olai Helgesen
Jones|Jones Mehus Hamadeh
Wulff|Wulff Røvik Hunstad
Sokrates|Sokrates Ullebø Hool
Serge|Serge Lions Tambue Kamga
Anas-Said|Anas-Said Rashid Qadi
Aune|Aune Brandseth Norbakk
Eliaz|Eliaz Eriksson
Estin|Estin Levorsen
Alexander-Bork|Alexander-Bork Carlsen Stien
Vinter|Vinter Andersson
Renzo|Renzo Haugedal
Aleksandrs|Aleksandrs Jakovlevs
Israel|Israel Mampasi
Vebrand|Vebrand Gangås
Yasr|Yasr Weldemoriam
Deep|Deep Flaglien
Agash|Agash Thileep
Javid|Javid Alami
Amiin|Amiin Aden Arten
Otelie|Otelie Ning Strand
Surafel|Surafel Kløvstad
Marceano|Marceano Cadjambor Mendes Silva
Giovani|Giovani Dos Santos Antonio
Zakeo|Zakeo Concepcion Maldia
Niel|Niel Bernard Bråten
Guleed|Guleed Abdulrahman Doaale
Beemnet|Beemnet Teffera
Thanh|Thanh Nguyen
Timofei|Timofei Porjajev
Jamil|Jamil Tarakheil
Pál|Pál Arpad Øyaland Nyiri
Tesfamichael|Tesfamichael Bieday Rezene
Heat|Heat Hines
Nemetullah|Nemetullah Ghazauri
Nani|Nani Kula
Dmitrij|Dmitrij Kuzkin
Alf-Georg|Alf-Georg Joranger
Regin|Regin Wernersen
Owe|Owe André Mikkelsen
Iacob|Iacob Mathiesen
Timothée|Timothée Jung
Kim-Andre|Kim-Andre Påhlman
Savez|Savez Omed
Hrafnkell|Hrafnkell Numi Bjarkason
Harni|Harni Varathan
Earl|Earl Aunevik
Jagathveek|Jagathveek Anandhan
Hakim|Hakim Andersen
Musamil|Musamil Ahmed Dahir
Klass|Klass Rainers Jansons
Owain|Owain Wyn Jones
Nuttaphong|Nuttaphong Somyunpon
Save|Save Brautaset
Shaho|Shaho Ostadahmadi
Habtom|Habtom Gebremeskel Negash
Timmi|Timmi Brandvik Anderl
Biniam|Biniam Hayleab
Ihne|Ihne Marie Johnsen
Ayne|Ayne Kifle Aalen
Berge|Berge Solberg
Jørn-Are|Jørn-Are Longfjeld
Troels|Troels Ravn
Daniell|Daniell Kaarbø
Zyad|Zyad Qashua
Robil|Robil Estifanos Tesfay
Arsenii|Arsenii Perebyinis
Mortimer|Mortimer Feliot
Enock|Enock Buyinza
Olivier|Olivier Krzystek
Pär|Pär Christian Magnusson
Franciszek|Franciszek Kedzierski
Binhazi|Binhazi Abdigesy Mohamud
Emal|Emal Shinwari
Liloz|Liloz Aimhmod
Mirac|Mirac Ugur
Mensah|Mensah Nyarko
Amun|Amun Austbø Dvergsdal
Shehab|Shehab Amr Ibrahim
Soland|Soland Glad Myrbakk
Lionell|Lionell Luca Lundberg Larsen
Sverke|Sverke Såtendal
Marley|Marley Delvyn-Thomas Leader
Oleg|Oleg Buvik-Aasgard
Mino|Mino Ridar-Aasen
Mathèo|Mathèo Müller Schackt
Sabin|Sabin Carstea
Michail|Michail Alexandros Antonakopoulos
Anes|Anes Maksumic
Fynn|Fynn Luca Daniel
Bjørn-Anders|Bjørn-Anders Eriksen
Vilgot|Vilgot Wold
Krizander|Krizander Magnussen
Radoslav|Radoslav Krasimirov Minchev
Fredric|Fredric Ndayitwayeko
Alf-Joakim|Alf-Joakim Esosa Valde
Grégory|Grégory Bernage
Remark|Remark Rrozhani
Kaj-Robin|Kaj-Robin Weslien
David-George|David-George Stan
Ivo|Ivo Leidal
Rainer|Rainer Røssvoll
Krisander|Krisander Kringen
Pepe|Pepe Mo Heising
Natanael|Natanael Iver Raabjerg Wennerberg
Leaf|Leaf Elliott Guerithault
Rashid|Rashid Hassan Ahmed
Halle|Halle Gjerstad
Ludwik|Ludwik Monsrud-Sikorski
Hayato|Hayato Tanno
Ville|Ville Emil Wingstedt
Muaad|Muaad Abdullahi Mohammud
Bertin|Bertin Sæle
Wojciech|Wojciech Szmelter
Kitti|Kitti Srimuang
Shanurat|Shanurat Gunsa
Malo|Malo Quiniou
Esrom|Esrom Gebremedhn Weldu
Gunnleik|Gunnleik Langeland
Yoann|Yoann Rouzieres
Oliwier|Oliwier Damian Adamczyk
Kristen-André|Kristen-André Olsen
Jiri|Jiri Hesselink Cornelissen
Nero|Nero Alexander Liebig
Vladislav|Vladislav Volkov
Indy|Indy Nicolas Laborde-Castagnet Røren
Damiao|Damiao Marie Humbert De Villardi De Montlaur Pagarete
Kesineb|Kesineb Tasfaselassie
Shamil|Shamil Iminov
Karam|Karam Ibrahim
Ubey|Ubey Adem
Sølver|Sølver Snøløs Topland
Nikhilkanth|Nikhilkanth Chandra Mohan
Mardochee|Mardochee Mbaya Mwamba
Pietro|Pietro Fitzhugh
Ersi|Ersi Rrozhani
Amund-Emil|Amund-Emil Slåttsveen
Hlib|Hlib Varava
Sofiane|Sofiane Meslier
Tibo|Tibo Coremans
Martins|Martins Jankovskis
Veiko|Veiko Saarestik
Nito|Nito Simonsen
Svein-Åge|Svein-Åge Karlsen
Dmytro|Dmytro Riepka
Ronnie|Ronnie Viken
Jander|Jander Heil
Amel|Amel Jodanovic
Bartavie|Bartavie Imanzi
Francin|Francin Anoj Vincent
Mazin|Mazin Elfadil Bakhat Hassan
Frank-Ole|Frank-Ole Østervold Skår Sjursen
Ebi|Ebi Fahadi-Elmenhorst
Risto|Risto Reimus
Vlad|Vlad Filip Nanciu
Yaroslav|Yaroslav Kotenko
Alver|Alver Inderhaug
Boom|Boom Mrat Aung
Bartlomiej|Bartlomiej Grzegorz Reimus
Humam|Humam Milhem
Lutz|Lutz Mütschard
Eloise|Eloise Elisdotter Kask
Ronnel|Ronnel Mathiassen
Kashif|Kashif Weigård Mir
Radoslaw|Radoslaw Uliasz
Quincy|Quincy Douglas
Feliks|Feliks Falk
Kaitlinn|Kaitlinn Esther Powell
Birgith|Birgith Kolstad Åsegg
Keziah|Keziah Killmer
Isato|Isato Nyema Jawara
Lilliane|Lilliane Johansen
Inés|Inés Stenhammer
Solene|Solene Cordonnier
Silje-Emilie|Silje-Emilie Rygg
Oshin|Oshin Heen
Tsige|Tsige Gerberhan Oqbazgi
Kirvil|Kirvil Schau Odden
Ger|Ger Wijnandus van Graas
Grzegorz|Grzegorz Bartosz Kosel
Madelein|Madelein Gundersen
Astri-Louise|Astri-Louise Nevstad
Runi|Runi Vold
Mailin|Mailin Andersen
Mylie|Mylie Veland Thomassen
Rachael|Rachael Eide
Roselinn|Roselinn Nygård Øien
Haddyjatou|Haddyjatou Jobe
Idil|Idil Yashin
Linn-Cecilie|Linn-Cecilie Salomonsen Sandanger
Bintou|Bintou Sesay
Else-Beate|Else-Beate Lerfald
Ylinn|Ylinn Tennebø
Lare|Lare Amin
Adelie|Adelie Lian Hoel
Manchari|Manchari L. Ahilan
Kaitesi|Kaitesi Ertzgaard
Thusanthi|Thusanthi Thavendren
Hanni|Hanni Skifjeld Arvesen
Melenie|Melenie Frölinghaus
Ghuthai|Ghuthai Zafari
Christense|Christense Eikenes
Janni|Janni Røssevold
Evie|Evie Kalnes Dencker
Rowene|Rowene Wingstad
Anpitkiniyal|Anpitkiniyal Kohulan
Eilin|Eilin Friestad
Karlijn|Karlijn Achterberg
Tiare|Tiare Oyarce
Siiri|Siiri Maija Sipilæ Næss
Oleane|Oleane Fagerli Bjørnebekk
Mariat|Mariat Pashaeva
Maylin|Maylin Olaisen. Wik
Mone|Mone Lurås
Giedre|Giedre Vainauskas
Solveig-Marie|Solveig-Marie Huus
Elvie|Elvie May Buanes
Whydah|Whydah Uwampa Kwizera
Ragndi|Ragndi Thea Østbø
Aylin|Aylin Åsli
Reese|Reese Bendiksen
Eugenie|Eugenie W Gulowsen
Merel|Merel Dirksen
Cilje|Cilje Malin Foss
Dung|Dung Kim Lieu
May-Liss|May-Liss Sundsvik Johnsen
Frigg|Frigg Winther Rugset
Maike|Maike Verhofstad
Soretti|Soretti Watne
Inger-Malene|Inger-Malene Westerås
Yme|Yme Seglsten Thompson
Veliane|Veliane Narnor
Emie|Emie Førre
Ellisif|Ellisif Luytkis Holstrøm
Lemet|Lemet Daniel Korneliussen
Thea-Marie|Thea-Marie Pettersen
Yulieth|Yulieth Hagen
Kemi|Kemi Akinyemi
Noi|Noi Yotphut
May-Linn|May-Linn Skuland
Sunnive|Sunnive Myklebust
Adriane|Adriane Pundsnes
Olivie|Olivie van der Voort
Suvathi|Suvathi Kulam
Nkemdilim|Nkemdilim Okolo
Sanyu|Sanyu Nsubuga
Selin|Selin Steinkjer Inci
Kerene|Kerene Kasongo
Britney|Britney Benert
Eilén|Eilén Brenne
Id-Sofie|Id-Sofie Østenstad
Ovedie|Ovedie Bjørndalsæter
Ingse|Ingse Gine Landro
Jenni|Jenni Askvig
Janko|Janko Radovanovic
Reinhold|Reinhold Rønstad
Elizabete|Elizabete Elina Cakure
Masome|Masome Karimi
Charinrat|Charinrat P. Moe
Ive-Mari|Ive-Mari Hallstensen
Zoè|Zoè Bertin
Marin|Marin Stray Gautadottir
Avril|Avril Mikkelsen Frei
Hanah|Hanah Larsen
Raz|Raz Said
Ahrani|Ahrani Vijijenthira
Ise|Ise Sveen
Ruairi|Ruairi Timothy Long
Mumbi|Mumbi Wanyoike Dalen
Ane-Marte|Ane-Marte Borg Hanssen
Niat|Niat Bisrat Tesfai
Aislin|Aislin Féliot
Merjem|Merjem Muratovic
Kimberlee|Kimberlee Aronsveen
Solvei|Solvei Aunøien Råen
Miriel|Miriel Eriksen
Ibtissam|Ibtissam Abounnachat
Signe-Marie|Signe-Marie Torvund
Ågot|Ågot Susann Bitustøyl
Kirstin|Kirstin Lovise Moen
Linne|Linne Ausland
Bricyn|Bricyn Barziza
Thiril|Thiril Erichsen
Nikole|Nikole Radunceva
Vårinn|Vårinn Kvåle
Akshayah|Akshayah Vijai
Thulasi|Thulasi Surendiran
Jøri|Jøri Vatten
Christanse|Christanse Bunes
Marijne|Marijne Janssens
Makromah|Makromah Kanneh
Veni|Veni Dahl-Bruheim
Sáve|Sáve Márjá Javo
Urd|Urd Dalen
Linh|Linh Huynh
Leonore|Leonore On-A-Mon Schultz-Kolberg
Ifrah|Ifrah Abdi
Denys|Denys Chechelnytskyy
Eylül|Eylül Aygün
Bjørn-Inge|Bjørn-Inge Flølo Kleppe
Ebise|Ebise Wako Liban
Saule|Saule Zemaitaityte
Kim-Petter|Kim-Petter Bakken
Tellei|Tellei Hermansen
Jebril|Jebril Broma Shmeis
Simerjit|Simerjit Singh
Aimée|Aimée Rønnestad Nærbø
Annmarie|Annmarie Eriksen
Anve|Anve Tveit
Godelieve|Godelieve Andrea Cornelia Deckers
Barah|Barah Mohamed Kamal
Fatu|Fatu Koroma
Imke|Imke Jurgens
Desireé|Desireé H. Andersson
Eik|Eik Viljar Nertun Jøsendal
Birmeji|Birmeji Geda Wayu
Quang|Quang Tran
Michele|Michele Milay Delos Santos
Fahrad|Fahrad Ghanavatian
Sarawut|Sarawut Yupakhot
Tesfagabr|Tesfagabr Ayahuney
Naphansiri|Naphansiri Nithuram
Jhordan-Konadu|Jhordan-Konadu Mensah
Vendelinn|Vendelinn Rosså
Jøte|Jøte Toftaker
Fartein|Fartein Fluge
Veronje|Veronje Kristoffersen
Moy|Moy Iversen
Dawthlei|Dawthlei Za Thang
Aino|Aino Kolltveit
Agne|Agne Skretting
Svend-Tore|Svend-Tore Aasvik
Quinty|Quinty Frenay
Tidemann|Tidemann Hamre
Nedim|Nedim Dizdarevic
Gabriek|Gabriek Langeland
Rim|Rim Kamboui
Maksym|Maksym Lakatosh
Eiri|Eiri Henriksdotter Blekken
Soheib|Soheib Abdulwahab
Suhayb|Suhayb Ali Omar
Boony|Boony Geleta
Lukass|Lukass Baikovs
Sakthi|Sakthi Prabu
Amélie|Amélie Bauer-Furnes
Vilde-Sofie|Vilde-Sofie Torvund
Thu-Dang|Thu-Dang Sophie Ly
Svenning|Svenning Veiseth
Silai|Silai Sarwary
Warisse|Warisse Anais Ljones
Maryam|Maryam Idowu
Wendel|Wendel Marie Håvardstun
Selihom|Selihom Amanuel Andemariam
Kamille-My|Kamille-My Bak Madsen
Kenzo|Kenzo Coulibaly Johannessen
Ugné|Ugné Trijonyte
Camille|Camille M Urbye
Julienne|Julienne Simakala
Esmee|Esmee Vermeulen
Liv-Amelie|Liv-Amelie Heite
Amann|Amann Yousaf
Edin|Edin Jaskic
Anfal|Anfal El Yamani Haida
Tsegay|Tsegay Breketab Kidane
Våri|Våri Henriksen
Frederikke|Frederikke Brun
Ingelinn|Ingelinn Frisk Remman
Dhiviyajothy|Dhiviyajothy Shankkar
Arsene|Arsene Simbi
Ricards|Ricards Adrians Plikausis
Skodre|Skodre Stensveen
Jori|Jori Mørkve
Lionel|Lionel Egou Gylland
Nandini|Nandini Heyerdahl Gonjari
Trond-August|Trond-August Flatås
Lowe|Lowe Gulle Brokstad
Samsam|Samsam Seleban
Fie|Fie Robertsen
Eilidh|Eilidh Macleod
Habteab|Habteab Mehreteab
Clemens|Clemens Øxnevad
Hatice|Hatice Hanna Tangerås
Javi|Javi Mertens
Yamah|Yamah Gbelee
Micho|Micho Shepard Cyiza
Cornelie|Cornelie Bjerkestrand Sandem
Winnie|Winnie Brækken
Yorsalem|Yorsalem Tesfai Berhane
Haddy|Haddy Jailan Njie
Gro-Ingvild|Gro-Ingvild Bondal
Ukeme|Ukeme Israel Daniel
Liyah|Liyah Velten Klubbenes
Elfi|Elfi Stene Dyrhaug
Lihaim|Lihaim Samuel Kifle
Jennyfer|Jennyfer Kouakou
Arthi|Arthi Suganthan
Rani|Rani Selvåg
Ariélle|Ariélle Beyer Broch
Mfonobong|Mfonobong Uduak Mme
Sahed|Sahed Omar Siyam
Peniel|Peniel Kifleyesus
Buthainah|Buthainah Jaber
Ariam|Ariam Michael Solomon
Marlin|Marlin Haavengen
Desirée|Desirée Jacobsen
Namo|Namo Bourat
Askeld|Askeld Sætre
Kanutte|Kanutte Baade Eiken
Sergei|Sergei Tsirunjan
Andry|Andry Kristian Strømmen Andrianjafintrimo
Iril|Iril Lenasdatter Sætre
Inger-Emilie|Inger-Emilie Dundas-Johansen
Linneah|Linneah Kvamsdal Guddal
